"filename", "language", "Makefile", "C", "Shell Script", "nasm", "C++", "comment", "blank", "total"
"c:\Users\带ta去蒙古国\Desktop\自己动手写操作系统\第十一章 尾声\03 在真机上运行\Makefile", "Makefile", 229, 0, 0, 0, 0, 15, 63, 307
"c:\Users\带ta去蒙古国\Desktop\自己动手写操作系统\第十一章 尾声\03 在真机上运行\boot\boot.asm", "nasm", 0, 0, 0, 197, 0, 20, 15, 232
"c:\Users\带ta去蒙古国\Desktop\自己动手写操作系统\第十一章 尾声\03 在真机上运行\boot\hdboot.asm", "nasm", 0, 0, 0, 148, 0, 53, 27, 228
"c:\Users\带ta去蒙古国\Desktop\自己动手写操作系统\第十一章 尾声\03 在真机上运行\boot\hdldr.asm", "nasm", 0, 0, 0, 459, 0, 187, 96, 742
"c:\Users\带ta去蒙古国\Desktop\自己动手写操作系统\第十一章 尾声\03 在真机上运行\boot\include\fat12hdr.inc", "nasm", 0, 0, 0, 24, 0, 9, 1, 34
"c:\Users\带ta去蒙古国\Desktop\自己动手写操作系统\第十一章 尾声\03 在真机上运行\boot\include\lib.inc", "nasm", 0, 0, 0, 116, 0, 20, 12, 148
"c:\Users\带ta去蒙古国\Desktop\自己动手写操作系统\第十一章 尾声\03 在真机上运行\boot\include\loader.inc", "nasm", 0, 0, 0, 34, 0, 9, 7, 50
"c:\Users\带ta去蒙古国\Desktop\自己动手写操作系统\第十一章 尾声\03 在真机上运行\boot\include\pm.inc", "nasm", 0, 0, 0, 40, 0, 18, 7, 65
"c:\Users\带ta去蒙古国\Desktop\自己动手写操作系统\第十一章 尾声\03 在真机上运行\boot\loader.asm", "nasm", 0, 0, 0, 404, 0, 51, 25, 480
"c:\Users\带ta去蒙古国\Desktop\自己动手写操作系统\第十一章 尾声\03 在真机上运行\command\Makefile", "Makefile", 37, 0, 0, 0, 0, 7, 15, 59
"c:\Users\带ta去蒙古国\Desktop\自己动手写操作系统\第十一章 尾声\03 在真机上运行\command\echo.c", "C", 0, 11, 0, 0, 0, 1, 1, 13
"c:\Users\带ta去蒙古国\Desktop\自己动手写操作系统\第十一章 尾声\03 在真机上运行\command\pwd.c", "C", 0, 9, 0, 0, 0, 0, 1, 10
"c:\Users\带ta去蒙古国\Desktop\自己动手写操作系统\第十一章 尾声\03 在真机上运行\command\start.asm", "nasm", 0, 0, 0, 12, 0, 7, 4, 23
"c:\Users\带ta去蒙古国\Desktop\自己动手写操作系统\第十一章 尾声\03 在真机上运行\fs\link.c", "C", 0, 130, 0, 0, 0, 66, 20, 216
"c:\Users\带ta去蒙古国\Desktop\自己动手写操作系统\第十一章 尾声\03 在真机上运行\fs\main.c", "C", 0, 330, 0, 0, 0, 189, 50, 569
"c:\Users\带ta去蒙古国\Desktop\自己动手写操作系统\第十一章 尾声\03 在真机上运行\fs\misc.c", "C", 0, 99, 0, 0, 0, 63, 21, 183
"c:\Users\带ta去蒙古国\Desktop\自己动手写操作系统\第十一章 尾声\03 在真机上运行\fs\open.c", "C", 0, 257, 0, 0, 0, 134, 55, 446
"c:\Users\带ta去蒙古国\Desktop\自己动手写操作系统\第十一章 尾声\03 在真机上运行\fs\read_write.c", "C", 0, 93, 0, 0, 0, 22, 15, 130
"c:\Users\带ta去蒙古国\Desktop\自己动手写操作系统\第十一章 尾声\03 在真机上运行\include\config.h", "C++", 0, 0, 0, 0, 4, 0, 0, 4
"c:\Users\带ta去蒙古国\Desktop\自己动手写操作系统\第十一章 尾声\03 在真机上运行\include\console.h", "C++", 0, 0, 0, 0, 17, 0, 3, 20
"c:\Users\带ta去蒙古国\Desktop\自己动手写操作系统\第十一章 尾声\03 在真机上运行\include\const.h", "C++", 0, 0, 0, 0, 170, 49, 26, 245
"c:\Users\带ta去蒙古国\Desktop\自己动手写操作系统\第十一章 尾声\03 在真机上运行\include\elf.h", "C++", 0, 0, 0, 0, 61, 2, 7, 70
"c:\Users\带ta去蒙古国\Desktop\自己动手写操作系统\第十一章 尾声\03 在真机上运行\include\fs.h", "C++", 0, 0, 0, 0, 59, 69, 13, 141
"c:\Users\带ta去蒙古国\Desktop\自己动手写操作系统\第十一章 尾声\03 在真机上运行\include\global.h", "C++", 0, 0, 0, 0, 37, 1, 1, 39
"c:\Users\带ta去蒙古国\Desktop\自己动手写操作系统\第十一章 尾声\03 在真机上运行\include\hd.h", "C++", 0, 0, 0, 0, 58, 54, 18, 130
"c:\Users\带ta去蒙古国\Desktop\自己动手写操作系统\第十一章 尾声\03 在真机上运行\include\keyboard.h", "C++", 0, 0, 0, 0, 95, 17, 13, 125
"c:\Users\带ta去蒙古国\Desktop\自己动手写操作系统\第十一章 尾声\03 在真机上运行\include\keymap.h", "C++", 0, 0, 0, 0, 133, 7, 6, 146
"c:\Users\带ta去蒙古国\Desktop\自己动手写操作系统\第十一章 尾声\03 在真机上运行\include\process.h", "C++", 0, 0, 0, 0, 104, 12, 6, 122
"c:\Users\带ta去蒙古国\Desktop\自己动手写操作系统\第十一章 尾声\03 在真机上运行\include\protect.h", "C++", 0, 0, 0, 0, 132, 18, 19, 169
"c:\Users\带ta去蒙古国\Desktop\自己动手写操作系统\第十一章 尾声\03 在真机上运行\include\proto.h", "C++", 0, 0, 0, 0, 89, 2, 3, 94
"c:\Users\带ta去蒙古国\Desktop\自己动手写操作系统\第十一章 尾声\03 在真机上运行\include\sconst.inc", "nasm", 0, 0, 0, 32, 0, 5, 2, 39
"c:\Users\带ta去蒙古国\Desktop\自己动手写操作系统\第十一章 尾声\03 在真机上运行\include\stdio.h", "C++", 0, 0, 0, 0, 16, 1, 2, 19
"c:\Users\带ta去蒙古国\Desktop\自己动手写操作系统\第十一章 尾声\03 在真机上运行\include\string.h", "C++", 0, 0, 0, 0, 11, 0, 0, 11
"c:\Users\带ta去蒙古国\Desktop\自己动手写操作系统\第十一章 尾声\03 在真机上运行\include\tty.h", "C++", 0, 0, 0, 0, 18, 2, 3, 23
"c:\Users\带ta去蒙古国\Desktop\自己动手写操作系统\第十一章 尾声\03 在真机上运行\include\type.h", "C++", 0, 0, 0, 0, 12, 0, 0, 12
"c:\Users\带ta去蒙古国\Desktop\自己动手写操作系统\第十一章 尾声\03 在真机上运行\kernel\clock.c", "C", 0, 37, 0, 0, 0, 16, 5, 58
"c:\Users\带ta去蒙古国\Desktop\自己动手写操作系统\第十一章 尾声\03 在真机上运行\kernel\console.c", "C", 0, 105, 0, 0, 0, 29, 9, 143
"c:\Users\带ta去蒙古国\Desktop\自己动手写操作系统\第十一章 尾声\03 在真机上运行\kernel\global.c", "C", 0, 43, 0, 0, 0, 32, 8, 83
"c:\Users\带ta去蒙古国\Desktop\自己动手写操作系统\第十一章 尾声\03 在真机上运行\kernel\hd.c", "C", 0, 270, 0, 0, 0, 112, 19, 401
"c:\Users\带ta去蒙古国\Desktop\自己动手写操作系统\第十一章 尾声\03 在真机上运行\kernel\i8259A.c", "C", 0, 37, 0, 0, 0, 22, 8, 67
"c:\Users\带ta去蒙古国\Desktop\自己动手写操作系统\第十一章 尾声\03 在真机上运行\kernel\kernel.asm", "nasm", 0, 0, 0, 251, 0, 78, 20, 349
"c:\Users\带ta去蒙古国\Desktop\自己动手写操作系统\第十一章 尾声\03 在真机上运行\kernel\keyboard.c", "C", 0, 269, 0, 0, 0, 62, 17, 348
"c:\Users\带ta去蒙古国\Desktop\自己动手写操作系统\第十一章 尾声\03 在真机上运行\kernel\klib.c", "C", 0, 94, 0, 0, 0, 39, 13, 146
"c:\Users\带ta去蒙古国\Desktop\自己动手写操作系统\第十一章 尾声\03 在真机上运行\kernel\kliba.asm", "nasm", 0, 0, 0, 178, 0, 42, 12, 232
"c:\Users\带ta去蒙古国\Desktop\自己动手写操作系统\第十一章 尾声\03 在真机上运行\kernel\main.c", "C", 0, 272, 0, 0, 0, 88, 38, 398
"c:\Users\带ta去蒙古国\Desktop\自己动手写操作系统\第十一章 尾声\03 在真机上运行\kernel\process.c", "C", 0, 268, 0, 0, 0, 64, 12, 344
"c:\Users\带ta去蒙古国\Desktop\自己动手写操作系统\第十一章 尾声\03 在真机上运行\kernel\protect.c", "C", 0, 165, 0, 0, 0, 28, 9, 202
"c:\Users\带ta去蒙古国\Desktop\自己动手写操作系统\第十一章 尾声\03 在真机上运行\kernel\start.c", "C", 0, 29, 0, 0, 0, 8, 1, 38
"c:\Users\带ta去蒙古国\Desktop\自己动手写操作系统\第十一章 尾声\03 在真机上运行\kernel\systask.c", "C", 0, 35, 0, 0, 0, 3, 1, 39
"c:\Users\带ta去蒙古国\Desktop\自己动手写操作系统\第十一章 尾声\03 在真机上运行\kernel\tty.c", "C", 0, 230, 0, 0, 0, 120, 26, 376
"c:\Users\带ta去蒙古国\Desktop\自己动手写操作系统\第十一章 尾声\03 在真机上运行\lib\close.c", "C", 0, 21, 0, 0, 0, 11, 3, 35
"c:\Users\带ta去蒙古国\Desktop\自己动手写操作系统\第十一章 尾声\03 在真机上运行\lib\exec.c", "C", 0, 61, 0, 0, 0, 16, 12, 89
"c:\Users\带ta去蒙古国\Desktop\自己动手写操作系统\第十一章 尾声\03 在真机上运行\lib\exit.c", "C", 0, 22, 0, 0, 0, 6, 2, 30
"c:\Users\带ta去蒙古国\Desktop\自己动手写操作系统\第十一章 尾声\03 在真机上运行\lib\fork.c", "C", 0, 22, 0, 0, 0, 15, 3, 40
"c:\Users\带ta去蒙古国\Desktop\自己动手写操作系统\第十一章 尾声\03 在真机上运行\lib\getpid.c", "C", 0, 21, 0, 0, 0, 8, 3, 32
"c:\Users\带ta去蒙古国\Desktop\自己动手写操作系统\第十一章 尾声\03 在真机上运行\lib\lseek.c", "C", 0, 23, 0, 0, 0, 14, 2, 39
"c:\Users\带ta去蒙古国\Desktop\自己动手写操作系统\第十一章 尾声\03 在真机上运行\lib\misc.c", "C", 0, 87, 0, 0, 0, 54, 14, 155
"c:\Users\带ta去蒙古国\Desktop\自己动手写操作系统\第十一章 尾声\03 在真机上运行\lib\open.c", "C", 0, 24, 0, 0, 0, 14, 5, 43
"c:\Users\带ta去蒙古国\Desktop\自己动手写操作系统\第十一章 尾声\03 在真机上运行\lib\printf.c", "C", 0, 32, 0, 0, 0, 15, 5, 52
"c:\Users\带ta去蒙古国\Desktop\自己动手写操作系统\第十一章 尾声\03 在真机上运行\lib\read.c", "C", 0, 23, 0, 0, 0, 14, 3, 40
"c:\Users\带ta去蒙古国\Desktop\自己动手写操作系统\第十一章 尾声\03 在真机上运行\lib\stat.c", "C", 0, 25, 0, 0, 0, 9, 5, 39
"c:\Users\带ta去蒙古国\Desktop\自己动手写操作系统\第十一章 尾声\03 在真机上运行\lib\string.asm", "nasm", 0, 0, 0, 83, 0, 14, 5, 102
"c:\Users\带ta去蒙古国\Desktop\自己动手写操作系统\第十一章 尾声\03 在真机上运行\lib\syscall.asm", "nasm", 0, 0, 0, 20, 0, 4, 5, 29
"c:\Users\带ta去蒙古国\Desktop\自己动手写操作系统\第十一章 尾声\03 在真机上运行\lib\unlink.c", "C", 0, 22, 0, 0, 0, 11, 4, 37
"c:\Users\带ta去蒙古国\Desktop\自己动手写操作系统\第十一章 尾声\03 在真机上运行\lib\vsprintf.c", "C", 0, 102, 0, 0, 0, 14, 15, 131
"c:\Users\带ta去蒙古国\Desktop\自己动手写操作系统\第十一章 尾声\03 在真机上运行\lib\wait.c", "C", 0, 21, 0, 0, 0, 10, 4, 35
"c:\Users\带ta去蒙古国\Desktop\自己动手写操作系统\第十一章 尾声\03 在真机上运行\lib\write.c", "C", 0, 23, 0, 0, 0, 14, 3, 40
"c:\Users\带ta去蒙古国\Desktop\自己动手写操作系统\第十一章 尾声\03 在真机上运行\mm\exec.c", "C", 0, 80, 0, 0, 0, 14, 11, 105
"c:\Users\带ta去蒙古国\Desktop\自己动手写操作系统\第十一章 尾声\03 在真机上运行\mm\forkexit.c", "C", 0, 145, 0, 0, 0, 144, 19, 308
"c:\Users\带ta去蒙古国\Desktop\自己动手写操作系统\第十一章 尾声\03 在真机上运行\mm\main.c", "C", 0, 75, 0, 0, 0, 46, 13, 134
"c:\Users\带ta去蒙古国\Desktop\自己动手写操作系统\第十一章 尾声\03 在真机上运行\viewdisk.sh", "Shell Script", 0, 0, 7, 0, 0, 12, 4, 23
"Total", "-", 266, 3612, 7, 1998, 1016, 2312, 895, 10106